WWWWWWWWWWWWWWWWWWWWWWWWWWWWWWWWWWWWWWWWWWWWWWWWWWWWWWWWWWWWWWWWWWWWWWWWWWWWWWWWWWWWWWWWWWWWWWWWWWWWWWWWW
W         W                       W         W         W                       W                         W
W         W                       W         W         W                       W                         W
W         W     WW        WW      W         W         W                       W    WW     WW            W
W         W     WW        WW      W                             WW         WWWW    WW     WW   W        W
W         W                       W                             WW                             WW       W
W         W                       W         W         W                                                 W
W                                 WWWW      W         W                   WW                            W
W    O                                      W         WWWWWWWWWWW         WW        W         W         W
W         W                                 W         W         W                   W         W         W
W         W             WWWWWWWWWWW         WWWWWWWWWWW         W         WW        W         W         W
W         W             W         W         W         W         W         WW        W         W         W
W         W     WW      W                   W         W         W                   W         W         W
W         W     WW      W         W         W         W                   W         W         W         W
W         W                       W                   W                   W         W         W         W
W         W                       W                   W         W         W                             W
W         W             W         W                   W         W                   W         WW        W
W                       W         WWWWWWWWWWW         W         W         W         W         WW        W
W                       W         W         W         W         WWWWWWWWWWW         W                   W
WWWW   WWWWWWWWWWWWWWWWWW         W         W         W                   W         W      WWWWW        W
W                       W                   W                             W                    W        W
W                       W                                         WW     WW                    W        W
W                       W                                         W                                     W
W                       WWWWWWWW   WWWWWWWWWWWWWW  WWWWWWWWW                                            W
W                                     W                                 WW           WW        W        W
W                                     W                           W     WW           WW        W        W
W      WWWWWWWWWWWWWWWWWWWWWWWWWWWWWWWWWWWWWWWWWWWWWWWWWWWWWWW    W                            WWWWWWWWWW
W      W                                                          W                            W
W      W                                                          WWWWWWWWWWWWWWWWWWWWWWWWWWWWWW
W      W      
W      W         W
W      W         W
W      W         WWWWWWWWWWW
W      W         W
W      W         W
W      W         W
W      W         W
W      W         W
W      W         W
W             
W
W
W 












BBBBBBBBBBBBBBBBBBBBBBBBBBBBBBBBBBBBBBBBBBBBBBBBBBBBBBBBBBBBBW    W                                     W
BBBBBBBBBBBBBBBBBBBBBBBBBBBBBBBBBBBBBBBBBBBBBBBBBBBBBBBBBBBBBW    W                                     W
BBBBBBBBBBBBBBBBBBBBBBBBBBBBBBBBBBBBBBBBBBBBBBBBBBBBBBBBBBBBBW    W     WW                    WW        W
BBBBBBBBBBBBBBBBBBBBBBBBBBBBBBBBBBBBBBBBBBBBBBBBBBBBBBBBBBBBBW    W     WW                    WW        W
BBBBBBBBBBBBBBBBBBBBBBBBBBBBBBBBBBBBBBBBBBBBBBBBBBBBBBBBBBBBBW    W                                     W
BBBBBBBBBBBBBBBBBBBBBBBBBBBBBBBBBBBBBBBBBBBBBBBBBBBBBBBBBBBBBW    WWWWWWWWWWWWWWWWWWWWWWWW              W
BBBBBBBBBBBBBBBBBBBBBBBBBBBBBBBBBBBBBBBBBBBBBBBBBBBBBBBBBBBBBW                           W              W
BBBBBBBBBBBBBBBBBBBBBBBBBBBBBBBBBBBBBBBBBBBBBBBBBBBBBBBBBBBBBW   W    W    W    W    W   W              W
BBBBBBBBBBBBBBBBBBBBBBBBBBBBBBBBBBBBBBBBBBBBBBBBBBBBBBBBBBBBBW  WWW  WWW  WWW  WWW  WWW  W              W
BBBBBBBBBBBBBBBBBBBBBBBBBBBBBBBBBBBBBBBBBBBBBBBBBBBBBBBBBBBBBW   W    W    W    W    W   W              W
BBBBBBBBBBBBBBBBBBBBBBBBBBBBBBBBBBBBBBBBBBBBBBBBBBBBBBBBBBBBBW                           W              W
BBBBBBBBBBBBBBBBBBBBBBBBBBBBBBBBBBBBBBBBBBBBBBBBBBBBBBBBBBBBBW   W    W    W    W    W   W              W
BBBBBBBBBBBBBBBBBBBBBBBBBBBBBBBBBBBBBBBBBBBBBBBBBBBBBBBBBBBBBW  WWW  WWW  WWW  WWW  WWW  W              W
BBBBBBBBBBBBBBBBBBBBBBBBBBBBBBBBBBBBBBBBBBBBBBBBBBBBBBBBBBBBBW   W    W    W    W    W   W              W
BBBBBBBBBBBBBBBBBBBBBBBBBBBBBBBBBBBBBBBBBBBBBBBBBBBBBBBBBBBBBW                           W              W
BBBBBBBBBBBBBBBBBBBBBBBBBBBBBBBBBBBBBBBBBBBBBBBBBBBBBBBBBBBBBW   W    W    W    W    W   W              W
BBBBBBBBBBBBBBBBBBBBBBBBBBBBBBBBBBBBBBBBBBBBBBBBBBBBBBBBBBBBBW  WWW  WWW  WWW  WWW  WWW  W              W
BBBBBBBBBBBBBBBBBBBBBBBBBBBBBBBBBBBBBBBBBBBBBBBBBBBBBBBBBBBBBW   W    W    W    W    W   W              W
BBBBBBBBBBBBBBBBBBBBBBBBBBBBBBBBBBBBBBBBBBBBBBBBBBBBBBBBBBBBBW                                          W
BBBBBBBBBBBBBBBBBBBBBBBBBBBBBBBBBBBBBBBBBBBBBBBBBBBBBBBBBBBBBW   W    W    W    W    W   W              W
BBBBBBBBBBBBBBBBBBBBBBBBBBBBBBBBBBBBBBBBBBBBBBBBBBBBBBBBBBBBBWWWWWWWWWWWWWWWWWWWWWWWWWWWWWWWWWWWWWWWWWWWW