WWWWWWWWWWWWWWWWWWWWWWWWWWWWWWWWWWWWWWWWWWWWWWWWWWWWWWWWWWWWWWWWWWWWWWWWWWWWWWWWWWWWWWWWWWWWWWWWWWWWWWWWW
W         W                       W         W         W                       W                W        W
W         W                       W         W         W                       W                         W
W         W     WW        WW      W         W         W                       W    WW     WW            W
W         W     WW        WW      W                             WW         WWWW    WW     WW   W        W
W         W                       W                             WW                             WWW   WWWW
W         W                       W         W         W                                                 W
W                                 W         WWWWW  WWWW                    W                            W
W    O                                      W         W         WWWWW   WWWWWW    WWWW       WWW        W
W         W                                 W         W         W                   W         W         W
W         W             WWWWWWWWWWW         W         W         W         WW        W         W         W
W         W             W         W         W         WWW     WWW         WW        W         W         W
W         W     WW      W                   W         W         W                   W         W         W
WWW    WWWWW    WW      W         W         W         W                   WWWW   WWWWW       WW         W
W         W                       W                   W                   W         W         W         W
W         W                       WWW      WWW       WW         W         W                             W
W         W             W         W                   W         W                   W         WW        W
W                       W         W         W                   W         W         W         WW        W
W                       W         W         W         W         W         W         W                   W
WWWW  WWWWWWWWWWWWWWWWWWWW      WWWWW    WWWW         WWW     WWW         WWW     WWWWWW   WWWWWW      WW
W                       W                   W                             W                    W        W
W                       W                                         WW     WW                    W        W
W                       W                   W                     W                                     W
W                       WWWWWWWWW  WWWWWWWWWWWWWW  WWWWWWWWW                                            W
W                                     W                 W                                      W        W
W                                     W                           W                            W        W
WWWWWWWWWWWWWWWWWWWWWWWWWWWWWWWWWWWWWWWWWWWWWWWWWWWWWWWWWWWWWW    WWW                          WWWWWWWWWW
BBBBBBBBBBBBBBBBBBBBBBBBBBBBBBBBBBBBBBBBBBBBBBBBBBBBBBBBBBBBBW    W                                     W
BBBBBBBBBBBBBBBBBBBBBBBBBBBBBBBBBBBBBBBBBBBBBBBBBBBBBBBBBBBBBW    W                                     W
BBBBBBBBBBBBBBBBBBBBBBBBBBBBBBBBBBBBBBBBBBBBBBBBBBBBBBBBBBBBBW    W                                     W
BBBBBBBBBBBBBBBBBBBBBBBBBBBBBBBBBBBBBBBBBBBBBBBBBBBBBBBBBBBBBW    W                                     W
BBBBBBBBBBBBBBBBBBBBBBBBBBBBBBBBBBBBBBBBBBBBBBBBBBBBBBBBBBBBBW    W                                     W
BBBBBBBBBBBBBBBBBBBBBBBBBBBBBBBBBBBBBBBBBBBBBBBBBBBBBBBBBBBBBW    W                                     W
BBBBBBBBBBBBBBBBBBBBBBBBBBBBBBBBBBBBBBBBBBBBBBBBBBBBBBBBBBBBBW    WWWWWWWWWWWWWWWWWWWWWWWW              W
BBBBBBBBBBBBBBBBBBBBBBBBBBBBBBBBBBBBBBBBBBBBBBBBBBBBBBBBBBBBBW                           W              W
BBBBBBBBBBBBBBBBBBBBBBBBBBBBBBBBBBBBBBBBBBBBBBBBBBBBBBBBBBBBBW   W    W    W    W    W   W              W
BBBBBBBBBBBBBBBBBBBBBBBBBBBBBBBBBBBBBBBBBBBBBBBBBBBBBBBBBBBBBW  WWW  WWW  WWW  WWW  WWW  W              W
BBBBBBBBBBBBBBBBBBBBBBBBBBBBBBBBBBBBBBBBBBBBBBBBBBBBBBBBBBBBBW   W    W    W    W    W   W              W
BBBBBBBBBBBBBBBBBBBBBBBBBBBBBBBBBBBBBBBBBBBBBBBBBBBBBBBBBBBBBW                           W              W
BBBBBBBBBBBBBBBBBBBBBBBBBBBBBBBBBBBBBBBBBBBBBBBBBBBBBBBBBBBBBW   W    W    W    W    W   W              W
BBBBBBBBBBBBBBBBBBBBBBBBBBBBBBBBBBBBBBBBBBBBBBBBBBBBBBBBBBBBBW  WWW  WWW  WWW  WWW  WWW  W              W
BBBBBBBBBBBBBBBBBBBBBBBBBBBBBBBBBBBBBBBBBBBBBBBBBBBBBBBBBBBBBW   W    W    W    W    W   W              W
BBBBBBBBBBBBBBBBBBBBBBBBBBBBBBBBBBBBBBBBBBBBBBBBBBBBBBBBBBBBBW                           W              W
BBBBBBBBBBBBBBBBBBBBBBBBBBBBBBBBBBBBBBBBBBBBBBBBBBBBBBBBBBBBBW   W    W    W    W    W   W              W
BBBBBBBBBBBBBBBBBBBBBBBBBBBBBBBBBBBBBBBBBBBBBBBBBBBBBBBBBBBBBW  WWW  WWW  WWW  WWW  WWW  W              W
BBBBBBBBBBBBBBBBBBBBBBBBBBBBBBBBBBBBBBBBBBBBBBBBBBBBBBBBBBBBBW   W    W    W    W    W   W              W
BBBBBBBBBBBBBBBBBBBBBBBBBBBBBBBBBBBBBBBBBBBBBBBBBBBBBBBBBBBBBW                                          W
BBBBBBBBBBBBBBBBBBBBBBBBBBBBBBBBBBBBBBBBBBBBBBBBBBBBBBBBBBBBBW   W    W    W    W    W   W              W
BBBBBBBBBBBBBBBBBBBBBBBBBBBBBBBBBBBBBBBBBBBBBBBBBBBBBBBBBBBBBWWWWWWWWWWWWWWWWWWWWWWWWWWWWWWWWWWWWWWWWWWWW